7,7
1,1,1,1,1,1,1
1,101,0,0,0,0,1
1,101,0,0,0,0,1
1,0,0,0,0,0,1
1,0,0,0,0,0,1
1,0,0,0,0,0,1
1,1,1,1001,1,1,1