12,8
1,1,1,1,1,1,1,1,1,1,1,1
1,1004,0,0,0,0,0,0,0,0,0,1
1,1,1,0,1,1,1,1,1,1,0,1
1,1,1,0,1,1,1,1,1,1,0,1
1,1,1,0,0,0,0,0,1009,1,0,1
1,1,1,1,1,1,1,1,1,1,0,1
1,1000,0,0,0,0,0,0,0,0,0,1
1,1,1,1,1,1,1,1,1,1,1,1
