12,7
1,1,1,1,1,1,1,1,1,1,1,1
1,1002,0,0,0,0,0,0,0,0,0,1
1,1,1,1,1,1,1,0,1,1,0,1
1,0,0,0,0,0,0,0,0,0,0,1
1,0,1,0,1,1,1,1,1,0,1,1
1,0,0,0,0,0,0,0,0,0,1003,1
1,1,1,1,1,1,1,1,1,1,1,1
