9,7
1,1,1001,1,1,1,1,1,1
1,0,0,0,0,0,0,0,1
1,0,0,0,0,0,0,0,1
1,0,107,0,0,0,0,0,1
1,0,0,0,0,0,108,0,1
1,0,0,0,0,0,0,0,1
1,1,1,1,1,1,1,1,1