9,7
1,1,1,1,1,1,1,1,1
1,0,0,1,0,1,0,0,1
1,1,0,0,0,0,0,1,1
1004,0,0,0,0,0,0,106,1
1,1,0,0,0,0,0,1,1
1,0,0,1,0,1,0,0,1
1,1,1,1,1,1,1,1,1