8,7
1,1,1,1,1,1,1,1
1,1003,0,0,0,0,0,1
1,0,0,0,0,0,0,1
1,0,0,0,0,0,0,1
1,0,0,0,0,0,0,1
1,0,0,0,0,0,1004,1
1,1,1,1,1,1,1,1