12,12
1,1,1,1,1,1,1,1,1,1,1,1
1,1000,0,0,0,0,0,0,0,0,0,1
1,0,1,1,1,1,1,1,1,1,0,1
1,0,0,1,0,0,0,0,0,0,0,1
1,1,0,1,1,1,1,0,1,1,1,1
1,0,0,0,0,0,0,0,0,0,0,1
1,0,1,1,1,0,1,1,1,1,0,1
1,0,1,1,1,0,0,0,0,0,0,1
1,0,0,0,1,0,1,1,1,1,1,1
1,0,1,0,1,0,1,0,0,0,0,1
1,0,1,0,1,0,0,0,1,0,1001,1
1,1005,1,1,1,1,1,1,1,1,1,1