9,7
1,1,1,1,1,1,1,1,1
1,0,0,1,102,1,0,0,1
1,1,0,0,0,0,0,1,1
1,103,0,0,0,0,0,104,1
1,1,0,0,0,0,0,1,1
1,0,0,0,0,0,0,0,1
1,1,1,1,1001,1,1,1,1